10 10 10 10 10 10 10 10 10 10 10 10 10 10 10 10 10 10 10 10 
10 0 0 0 0 0 0 0 0 0 0 0 0 0 0 0 0 0 0 10 
10 4 4 4 4 4 4 4 4 4 4 4 4 4 4 4 4 4 4 10 
10 7 0 0 7 0 0 7 0 0 7 0 0 7 0 0 7 0 0 10 
10 7 0 0 7 0 0 7 0 0 7 0 0 7 0 0 7 0 0 10 
10 7 0 0 7 0 0 7 0 0 3 0 0 7 0 0 7 0 0 10 
10 7 0 0 7 0 0 7 0 0 7 0 0 7 0 0 7 0 0 10 
10 4 4 4 4 4 4 4 4 4 4 4 4 4 4 4 4 4 4 10 
10 7 0 0 7 0 0 7 0 0 7 0 0 7 0 0 7 0 0 10 
10 7 0 0 7 0 0 7 0 0 7 0 0 3 0 0 7 0 0 10 
10 7 0 0 7 0 0 3 0 0 7 0 0 7 0 0 7 0 0 10 
10 7 0 0 7 0 0 7 0 0 7 0 0 7 0 0 7 0 0 10 
10 4 4 4 4 4 4 4 4 4 4 4 4 4 4 4 4 4 4 10 
10 7 0 0 7 0 0 7 0 0 7 0 0 7 0 0 3 0 0 10 
10 7 0 0 7 0 0 7 0 0 7 0 0 7 0 0 7 0 0 10 
10 7 0 0 3 0 0 7 0 0 7 0 0 7 0 0 7 0 0 10 
10 7 0 0 7 0 0 7 0 0 7 0 0 7 0 0 7 0 0 10 
10 4 0 0 4 0 0 4 0 0 4 0 0 4 0 0 4 0 0 10 
10 0 0 0 0 0 0 0 0 0 0 0 0 0 0 0 0 0 0 10 
10 0 0 0 0 0 0 0 0 0 0 0 0 0 0 0 0 0 0 10 
10 0 0 0 0 0 0 0 0 0 0 0 0 0 0 0 0 0 0 10 
10 0 0 0 0 0 0 0 0 0 0 0 0 0 0 0 0 0 0 10 
10 0 0 0 0 0 0 0 0 0 0 0 0 0 0 0 0 0 0 10 
10 0 0 0 0 0 0 0 0 0 0 0 0 0 0 0 0 0 0 10 
10 0 0 0 0 0 0 0 0 0 0 0 0 0 0 0 0 0 0 10 
10 0 0 0 0 0 0 0 0 0 0 0 0 0 0 0 0 0 0 10 
10 0 0 0 0 0 0 0 0 0 0 0 0 0 0 0 0 0 0 10 
10 0 0 0 0 0 0 0 0 -1 0 0 0 0 0 0 0 0 0 10 
10 0 0 0 0 0 0 0 -2 -2 -2 0 0 0 0 0 0 0 0 10 
10 0 0 0 0 0 0 0 0 0 0 0 0 0 0 0 0 0 0 10 
