10 10 10 10 10 10 10 10 10 10 10 10 10 10 10 10 10 10 10 10 
10 10 10 10 10 10 10 10 10 10 10 10 10 10 10 10 10 10 10 10 
10 10 10 10 10 10 10 10 10 10 10 10 10 10 10 10 10 10 10 10 
10 10 10 10 10 10 10 10 10 10 10 10 10 10 10 10 10 10 10 10 
10 10 10 10 10 10 10 10 10 10 10 10 10 10 10 10 10 10 10 10 
10 10 10 10 10 10 10 10 10 10 10 10 10 10 10 10 10 10 10 10 
10 10 10 10 10 10 10 10 10 10 10 10 10 10 10 10 10 10 10 10 
10 0 0 0 0 8 0 0 0 0 0 0 0 0 8 0 0 0 0 10 
10 0 0 0 8 0 0 0 0 0 0 0 0 0 0 8 0 0 0 10 
10 0 0 8 0 0 0 0 0 0 0 0 0 0 0 0 8 0 0 10 
10 0 8 0 0 0 0 0 0 0 0 0 0 0 0 0 0 8 0 10 
10 8 0 0 0 0 0 0 0 0 0 0 0 0 0 0 0 0 8 10 
10 1 0 0 0 0 0 0 0 0 0 0 0 0 0 0 0 0 1 10 
10 0 1 0 0 0 0 0 0 5 5 0 0 0 0 0 0 1 0 10 
10 0 0 1 0 0 0 0 0 0 0 0 0 0 0 0 1 0 0 10 
10 0 0 0 5 9 0 0 0 0 0 0 0 0 9 5 0 0 0 10 
10 0 0 0 0 7 0 0 0 0 0 0 0 0 7 0 0 0 0 10 
10 0 0 0 0 0 7 0 0 0 0 0 0 7 0 0 0 0 0 10 
10 0 0 0 0 0 0 7 0 0 0 0 7 0 0 0 0 0 0 10 
10 0 0 0 0 0 0 0 7 0 0 7 0 0 0 0 0 0 0 10 
10 0 0 0 0 0 0 0 0 9 9 0 0 0 0 0 0 0 0 10 
10 0 0 0 0 0 0 0 0 0 0 0 0 0 0 0 0 0 0 10 
10 0 0 0 0 0 0 0 0 0 0 0 0 0 0 0 0 0 0 10 
10 0 0 0 0 0 0 0 0 0 0 0 0 0 0 0 0 0 0 10 
10 0 0 0 0 0 0 0 0 0 0 0 0 0 0 0 0 0 0 10 
10 0 0 0 0 0 0 0 0 0 0 0 0 0 0 0 0 0 0 10 
10 0 0 0 0 0 0 0 0 0 0 0 0 0 0 0 0 0 0 10 
10 0 0 0 0 0 0 0 0 -1 0 0 0 0 0 0 0 0 0 10 
10 0 0 0 0 0 0 0 -2 -2 -2 0 0 0 0 0 0 0 0 10 
10 0 0 0 0 0 0 0 0 0 0 0 0 0 0 0 0 0 0 10 
