10 10 10 10 10 10 10 10 10 10 10 10 10 10 10 10 10 10 10 10
10 1 0 0 1 0 0 1 0 0 1 0 0 1 0 0 1 0 0 10
10 1 0 0 1 0 0 1 0 0 1 0 0 1 0 0 1 0 0 10
10 1 0 0 1 0 0 1 0 0 1 0 0 1 0 0 1 0 0 10
10 1 0 0 1 0 0 1 0 0 1 0 0 1 0 0 1 0 0 10
10 1 0 0 1 0 0 1 0 0 1 0 0 1 0 0 1 0 0 10
10 1 0 0 1 0 0 1 0 0 1 0 0 1 0 0 1 0 0 10
10 1 0 0 1 0 0 1 0 0 1 0 0 1 0 0 1 0 0 10
10 1 0 0 1 0 0 1 0 0 1 0 0 1 0 0 1 0 0 10
10 1 0 0 1 0 0 1 0 0 1 0 0 1 0 0 1 0 0 10
10 1 0 0 1 0 0 1 0 0 1 0 0 1 0 0 1 0 0 10
10 3 3 3 3 3 3 4 4 4 4 4 4 4 4 4 4 4 5 10
10 1 0 0 1 0 0 1 0 0 1 0 0 1 0 0 1 0 0 10
10 1 0 0 1 0 0 1 0 0 1 0 0 1 0 0 1 0 0 10
10 0 0 0 0 0 0 0 0 0 0 0 0 0 0 0 0 0 0 10
10 0 0 0 0 0 0 0 0 0 0 0 0 0 0 0 0 0 0 10
10 0 0 0 1 0 0 0 0 0 0 0 0 0 0 1 0 0 0 10
10 0 0 0 0 0 0 0 0 0 0 0 0 0 0 0 0 0 0 10
10 0 0 0 0 0 0 0 0 0 0 0 0 0 0 0 0 0 0 10
10 0 0 0 0 0 0 0 0 0 0 0 0 0 0 0 0 0 0 10
10 0 0 0 0 0 0 0 0 0 0 0 0 0 0 0 0 0 0 10
10 0 0 0 0 0 0 0 0 0 0 0 0 0 0 0 0 0 0 10
10 0 0 0 0 0 0 0 0 0 0 0 0 0 0 0 0 0 0 10
10 0 0 0 0 0 0 0 0 0 0 0 0 0 0 0 0 0 0 10
10 0 0 0 0 0 0 0 0 0 0 0 0 0 0 0 0 0 0 10
10 0 0 0 0 0 0 0 0 0 0 0 0 0 0 0 0 0 0 10
10 0 0 0 0 0 0 0 0 0 0 0 0 0 0 0 0 0 0 10
10 0 0 0 0 0 -1 0 0 0 0 0 0 0 0 0 0 0 0 10
10 0 0 0 0 -2 -2 -2 0 0 0 0 0 0 0 0 0 0 0 10
10 0 0 0 0 0 0 0 0 0 0 0 0 0 0 0 0 0 0 10