0 10 0 0 0 0 0 0 0 0 0 0 0 0 0 0 0 0 10 0 
0 10 0 0 0 0 0 0 0 0 0 0 0 0 0 0 0 0 10 0 
0 10 0 0 0 0 0 0 0 0 0 0 0 0 0 0 0 0 10 0 
0 10 0 0 0 0 0 0 0 0 0 0 0 0 0 0 0 0 10 0 
10 10 0 0 0 0 0 10 10 10 10 10 10 0 0 0 0 0 10 10 
10 10 0 0 0 0 0 10 10 10 10 10 10 0 0 0 0 0 10 10 
0 7 7 7 7 7 7 0 0 0 0 0 0 5 5 5 5 5 9 0 
0 2 0 0 0 0 3 0 0 0 0 0 0 4 0 0 0 0 9 0 
0 2 0 0 0 0 3 0 10 10 10 10 0 4 0 0 0 0 9 0 
0 2 0 0 0 0 3 0 10 10 10 10 0 4 0 0 0 0 9 0 
0 2 0 0 0 0 3 0 0 0 0 0 0 4 0 0 0 0 9 0 
0 0 0 0 0 0 3 0 0 0 0 0 0 4 0 0 0 0 0 0 
0 0 0 0 0 0 3 0 0 0 0 0 0 4 0 0 0 0 0 0 
0 0 0 0 0 0 3 0 0 0 0 0 0 4 0 0 0 0 0 0 
0 0 0 0 0 0 3 0 0 0 0 0 0 4 0 0 0 0 0 0 
0 1 1 1 1 1 1 1 1 1 1 1 1 1 1 1 1 1 10 0 
0 6 0 0 0 0 3 0 0 0 0 0 0 4 0 0 0 0 10 0 
0 6 0 0 0 0 3 0 0 0 0 0 0 4 0 0 0 0 10 0 
0 6 4 4 4 4 4 0 0 0 0 0 0 8 8 8 8 8 8 0 
0 0 0 0 0 0 0 0 0 0 0 0 0 0 0 0 0 0 0 0 
0 0 0 0 0 0 0 0 0 0 0 0 0 0 0 0 0 0 0 0 
0 0 0 0 0 0 0 0 0 0 0 0 0 0 0 0 0 0 0 0 
0 0 0 0 0 0 0 0 0 0 0 0 0 0 0 0 0 0 0 0 
0 0 0 0 0 0 0 0 0 0 0 0 0 0 0 0 0 0 0 0 
0 0 0 0 0 0 0 0 0 0 0 0 0 0 0 0 0 0 0 0 
0 0 0 0 0 0 0 0 0 0 0 0 0 0 0 0 0 0 0 0 
0 0 0 0 0 0 0 0 0 0 0 0 0 0 0 0 0 0 0 0 
10 10 0 0 0 0 0 0 0 -1 0 0 0 0 0 0 0 0 10 10 
0 10 10 0 0 0 0 0 -2 -2 -2 0 0 0 0 0 0 10 10 0 
0 0 0 0 0 0 0 0 0 0 0 0 0 0 0 0 0 0 0 0 
